2 10 10
250
7 7 6 4 4 6 6 5 5 7
6 6 1 1 1 1 1 1 1 7
6 4 1 1 5 5 5 1 1 4
5 5 1 1 7 7 7 1 1 5
6 5 1 1 5 5 6 1 1 7
6 4 1 1 7 7 6 1 1 7
5 7 1 1 7 4 5 1 1 5
4 4 1 1 6 7 7 1 1 4
4 5 4 7 5 7 5 6 4 7
7 6 7 5 5 4 5 6 6 7
